1111111111111111111111111111111111111111111111111111111111111111111111111111111111111111111111111111
1111000001111111111111111111111111111111111111111111111111111111111111111111111111111111111111111111
1111000001111111111111111111111111111111111111111111111111111111111111111111111111111111111111111111
1111000001111111111111111111111111111111111111111111111111111111111111111111111111111111111111111111
1111111011111111111111111111111111111111111111111111111111111111111111111111111111111111111111111111
1111111011111111111111111111000000000011111111111111111111111110000001111111111111100000000000000011
1111111011111111111111111111000000000011111111111111110000000000000000000000000000000000000000000011
1111111011111100000000000000000000000011111111111111110111111110000001111111111111100000000000000011
1111111000000000000011111111000000000011111111111111110111111110000001111111111111111111111111111111
1111111111111100000011111111000000000011111111111111110111111110000001111111111111111111111111111111
1111111111111100000011111111000000000011111111111111110111111110000001111111111111111111111111111111
1111111111111100000000000000000000000011111111111111110111111111111111111111111111111111111111111111
1111111111111100000011111111000000000011111111111111110111111111111111111111111111111111111111111111
1111111111111100000011111111000000000011111111111111110111111111111111111111111111111111111111111111
1111111111111101011111100000000000000011111111111111110111111111111111111111111111111111111111111111
1111111111111101011111101111111011110111111111111111110111111111111111111111111111111000000000011111
1111111111111101011111101111111011110111111111111111110111111111111111111111111111111000000000011111
1111111111111101011111101111111011110111111111111111110111111111111111111111111111111000000000011111
1111111111111101011111101111111011110111111111111110000000011111111111111111111111111000000000011111
1111111111111101011111101111111011110111111111111110000000011111111111111111111111111000000000011111
1111111111111101011111101111111011110111111111111110000000011111111111111111111111111000000000011111
1111111111111101011111100000000011110111111000000000000000011111111111111111111111111101111111111111
1111111111111101011111101111111111110111111011111110000000011111111111111111111111111101111111111111
1111111111111101011111101111111111000000000011111110000000011111111111100000111111111101111111111111
1111111111111101011111101111111111000011111011111110000000011111111111100000111111111101111111111111
1111111111111101000000001111111111000011111011111110000000011111111111100000111111111101111111111111
1111111111111101011111111111111111000011111011111110000000011111111111100000000000000001111111111111
1111111111111101011111111111111111000011111011111110000000011111111111100000111111111111111111111111
1111111111111101000000000000000000000000000011111110101111111111111111100000111111111111111111111111
1111111111111101111111111111111111000011111111111110101111111111111111100000111111111111111111111111
1111111111111101111111111111111111000011111111111110101111111111111111110111111111111111111111111111
1111111111111101111111111111111111101111111111111110101111111111111111110111111111111111111111111111
1111111111111101111111111111111111101111111111111110101111111111111111110111111110000001111111111111
1111111111111101111111111111111111101111111111111110101111111111111111110000000000000001111111111111
1111111111111101111111111111111111101111111111111110101111111111111111110111111110000001111111111111
1111111111100000111111111111111111101111111111111110101111111111111111110111111110000001111111111111
1111111111100000111111111111111111101111111111111110101111111111111111110111111111101111111111111111
1111111111100000111111111111111111101111111111111110101111111111111111110111111111101111111111111111
1111111111100000111111111111111111101111111111111110101111111111111111110111111111101111111111111111
1111111111100000111111111111111111101111111111111110101111111111111000000111111111101111111111111111
1111111111100000111111111111111111101111111111111110101111111111111011110111111111100000000000000111
1111111111100000111111111000001111101111111111111110101111111111111011110111111111111111011111110111
1111111111100000111111111000001111101111111111111110101111111111111011110111111111111111011111110111
1111111111110111111111111000001111100000000000000000101111111111111011110111111111111111011111110111
1111111111110111111111111000001111101111111111111101101111111111111011110111111111111111011111110111
1111111111110111111111111000001111101111111111111101101111111111111011110000000011111111011111110111
1111111111110111111111111110111111101111111111111101101111111111111011110111111011111111011111110111
1111111111110111111111111110111111101111111111111101101111111111111011110111111011111111011111110111
1111111111110111111111111110111111101111111111111000000111111111111011110111111011111111011111110111
1111111111110111111111111110111111101111111111111000000111111111111011110111111011111111011111110111
1111111100000011111111111110111111101111111111111000000111111111111011110111111011111111011111110111
1111111100000011111111111110111111101111111111111000000000000000000011110111111011111111011111110111
1111111100000011111111111110111111101111111111111000000111111111111111110111111011111111011111110111
1111111100000011111111111110111111101111111111111000000111111111111111110111111011111111011111110111
1111111100000011111111111110111111101111111111111111111111111111111111110111111011100000000000000111
1111111101110111111111111110111111101111111111111111111111111111111111110111111011101111011111111111
1111111101110111111111111110111111101111111111111111111111111111111111110111111011101111011111111111
1111111101110111111111111110111111101111111111111111111111111111111111110111111011101111011111111111
1111111101110000000000000000111111101111111111111111111111111111111111110111111011101111011111111111
1111111101110111111000000000000000001111111111111111111111111111111111110110000001101111011111111111
1111111101110111111000000000111111101111111111111111111111111111111111110110000000001111011111111111
1111100000000011111000000000111111101111111111111111111111111111111111110110000001111111011111111111
1111100000000000000000000000000000000000000000000000000000000000000000000000000001111111011111111111
1111100000000011111000000000111111111101111111111111111111111111111111111110000001111111011111111111
1111100000000011111000000000111111111101111111111111111111111111111111111110000001111111011111111111
1111100000000011111000000000111111111101111111111111111111111111111111111110000001111111011111111111
1111100000000000000000000000111111111101111111111111111111111111111111111110000001111111011111111111
1111100000000011111000000000111111111101111111111111111111111111111111111110000001111100000001111111
1111100000000011111110111101111111111101111111111111111111111111111111111110000001111100000001111111
1111111110111111111110111101111111111101111111111111111111111000000000000000101111111100000001111111
1111111110111111111110111101111111111101111111111111111111111011111111111110101111111100000001111111
1111111110111111111110111101111111111101111111111111111111111011111111111110101111111100000001111111
1111111110111111111110111101111111111101111111111000011111111011111111111110101111111100000001111111
1111111110111111111110111101111111111101111111111000011111110000001111111110101111111111011011111111
1111111110111111111110111101111111111100000000000000011111110000001111111110101111111111011011111111
1111111110111111111110111101111111111111111111111000011111110000001111111110101111111111011011111111
1111111110111111111110111101111111111111111111111000000000000000001111111110101111111111011011111111
1111111110111111111110000001111111111111111111111000011111110000001111111110101111111111011011111111
1111111110111111111111011111111111111111111111111000011111110000001111111110101111111111011011111111
1111111110111111111111011111111111111111111111111000011111110000001111111110101111111111011011111111
1111111110111111111111011111111111111111111111111111011111110000000000000000001111111111011011111111
1111111100000011111111011111111111111111111111111111011111110000001111111111111111111111011011111111
1111111100000000000000011111111111111111111111111111011111111111011111111111111111111111011011111111
1111111100000011111111111111111111111111111111111111011111111111011111111111111111111111011011111111
1111111100000011111111111111111111111111111111111111011111111111011111111111111111111111011011111111
1111111100000011111111111111111111111111111111111111011111111111011111111111100000000011011011111111
1111111100000011111111111111111111111111111111111111011111111111011111111111100000000000000011111111
1111111111111111111111111111111111111111111111111111011111111111011111111111100000000011111111111111
1111111111111111111111111111111111111111111111111111000000000000000000000000000000000011111111111111
1111111111111111111111111111111111111111111111111111111111111111111111101111100000000011111111111111
1111111111111111111111111111111111111111111111111111111111111111111111101111100000000011111111111111
1111111111111111111111111111111111111111111111111111111111111111111111101111100000000011111111111111
1111111111111111111111111111111111111111111111111111111111111111111111101111100000000011111111111111
1111111111111111111111111111111111111111111111111111111111111111111111100000000000000011111111111111
1111111111111111111111111111111111111111111111111111111111111111111111111111111111111111111111111111
1111111111111111111111111111111111111111111111111111111111111111111111111111111111111111111111111111
1111111111111111111111111111111111111111111111111111111111111111111111111111111111111111111111111111
1111111111111111111111111111111111111111111111111111111111111111111111111111111111111111111111111111
1111111111111111111111111111111111111111111111111111111111111111111111111111111111111111111111111111
1111111111111111111111111111111111111111111111111111111111111111111111111111111111111111111111111111
